9,10
**********
  *       
* * **** *
*   **** *
** ****  *
**  *** **
*** *** **
***     **
**********
1,0,1,9