10,10
**********
    ******
* *** **  
*     *  *
* ***** **
*   **  **
*** ** ***
**   * ***
****   ***
**********
1,0,2,9